%%%%%%%%%%%%%%%%%%%%%%%%%%%%%%%%%%%%%%%%
%         %%%%%%%%%%%%%%%%%%%%%%%%%%%%%%
% %%%%%%% %%%%%%%%%%%%%%%%%%%%%%%%%%%%%%
%.                                    P%
%%%%%%%%%%%%%%%%%%%%%%%%%%%%%%%%%%%%%%%%                 